SQL문의 종류 :
<<<<<<< HEAD
1. DML :  Data
=======
1. DML :  Data Manipulation Language 데이터 검색, 수정 등
INSERT : 데이터베이스 객체에 데이터를 입력
DELETE : 데이터베이스 객체에 데이터를 삭제
UPDATE : 기존에 존재하는 데이터베이스 객체 안의 데이터 수정
SELECT : 데이터베이스 객체로부터 데이터를 검색
2.DDL : Data Definrtion Language : 데이터와 그 구조를 정의
CREATE : 데이터베이스 객체 생성
DROP : 데이터베이스 객체를 삭제
ALTER : 기존에 존재하는 데이터베이스 객체를 다시 정의
TRUNCATE : 데이터베이스 객체 내용 삭제
DCL : Data Control Language : 데이터베이스 사용자의 권한 제어
GRANT : 데이터베이스 객체에 권한 부여
REVOKE : 이미 부여된 데이터베이스 객체의 권한을 취소
COMMIT : 트랙잭션 확정
ROLLBACK : 트랜잭션 취소
SAVEPOINT : 복귀지점 설정
데이터 딕셔너리 뷰
DBA_XXXX : 데이터베이스 관리자만 접근 가능한 객체 등의 정보 조회
ALL_XXXX : 자신 계정 소유 또는 권한을 부여 받은 객체 등에 관한 정보 조호ㅢ
USER_XXXX :  자신의 계정에 소유한 객체 등에 관한 정보 조회
테이블의 제약조건
NOT NULL : 이필드는 NULL값을 포함하지 않음을 지정
UNIQUE : 테이블의 모든 행에 대해 유일해야 하는 값을 가진 열 또는 열의 조압을 지정
PRIMARY KEY : 유일하게 테이블의 각 행을 식별
FOREIGN KEY : 열과 참조된 테이블의 열 사이의 외래키 관계를 적용하고 설정
	       REFERENCES 예약어 사용 : 참조 무결성 제약 조건 지정
CHECK : 참이어야 하는 조건을 지정
DEFAULT : 제약조건은 아니나 쓸수있는 함수 
>>>>>>> 992af29367a179759e5fb6a6f956cbc3694c8f85
