태그란?
  - HTML문서를 구성하고 있는 요소, 열린태그와 닫힌태그로 나눠진다.
  - 태그에는 이름과 속성, 속성값이 있다.
1. Head 태그
    - meta : 웹 페이지의 추가 정보를 전달
    - title : 웹 페이지의 제목
    - script : 웹 페이지에 스크립트를 추가
    - link : 웹 페이지에 다른 파일을 추가
    - style : 웹 페이지의 스타일시트 추가
2.글자관련태그
 - h1(헤더 글씨) / p(본문) / br(개행) / a(앵커) / b / i / sup / del
3.목록태그
  - ul : 순서가 없는 목록태그
  - ol : 순서가 있는 목록태그 (disc, circle, square)
  - li : 목록 요소
4.표태그
  - tr : 표 내부의 행 태그
  - th : 행 내부의 열. 제목 셀 태그
  - td : 행 내부의 열. 일반 셀 태그
  -thead : 표 제목 / tbody : 표 본문 / tfoot : 표 하단 (선택)
5.이미지태그
  - src : 파일 경로 지정
  - alt : 이미지가 없을 때 ( 오류일때 ) 나오는 글자 지정
  - width : 이미지 너비 지정 (css 부분에 설정해주는 경우가 더 많다)
  - heigth : 이미지 높이 지정 (css 부분에 설정해주는 경우가 더 많다)
6.오디오/비디오태그
  - src : 파일 경로지정
  - preload : 재생하기전에 모두 불러올지 지정
  - autoplay : 반복 자동 재생 지정
  - loop : 반복할지 지정
  - conrols :재생 도구를 출력할지 지정
